.............................................................................
.............................................................................
.............................................................................
.............................................................................
.............................................................................
.............................................................................
.............................................................................
.............................................................................
.............................................................................
..............................##.............................................
.............................#...............................................
..........................###..........................##....................
......................####..........................###......................
.....................#............................##.........................
######################################.#############.........................
####################.................#.######################################
####################.................#.######################################
####################.......###########.######################################
####################.......#...........######################################
####################.......##################################################
####################.......##################################################
####################.......##################################################
####################.......##################################################
####################.......##################################################