.............................................................................
.............................................................................
.............................................................................
.............................................................................
.............................................................................
.............................................................................
.............................................................................
.............................................................................
.............................................................................
..............................##.............................................
.............................#...............................................
..........................###..........................##....................
......................####..........................###......................
.....................#............................##.........................
######################################..############.........................
####################.................#..#####################################
####################.................#..#####################################
####################.......###########..#####################################
####################.......#............#####################################
####################.......##################################################
####################.......##################################################
####################.......##################################################
####################.......##################################################
####################.......##################################################